###############################################################################################################################################################ZZZ######################################
##############################################################################################################################################################ZAAAZ#####################################
#############################################################################################################################################################ZAAAAAAZZZZZZZZ############################
##########################################################################################ZZ##############################################################ZZAAAAAAAAAAAAAAAAZ######ZZZ#ZZZ###########ZZ#
#################ZZZZ###################################################################ZCCCCZ###########################################ZZZ#########ZZAAAAAAAAAAAAAAAAAAAZZBBBBBZBBBBBZBBBBBBBBBBBZZZBZ
###############ZZDDDDZZZZZZ##########################################################ZCCCCCCCCZ################ZZZ#######################ZAAAZZZZZZZAAAAAAAAAAAZZZZBBBBBBBBBBBBBBBBBBBBBBBBBBBBBBBBBBBBZ
###############ZZDDDDDDDDDZZ######################################################ZCCCCCCCCCCCCCZ###########ZEEEEEZ##################ZZAAAAAAAAAAAAAAAAAAAAAAAZFFFFZBBBBBBBBBBBBBBBBBBBBBBBBBBBBBBBBBBBZ
################ZDDDDDDDDDDDZ#####ZZ######ZZZ##################################ZCCCCCCCCCCCCCCCCZ#########ZEEEEEEEEEZ###ZZZZ#######ZAAAAAAAAAAAAAAAAZZZZZZZFFFFFFFFFZBBBBBBBBBBBBBBBBBBBBBBBBBBBBBBBBBBZ
#################ZDDDDDDDDDDDZ#####ZGGZZGGGGGGZ#####ZZ####################ZCCCCCCCCCCCCCCCCCCCCCCCZ#####ZEEEEEEEEEZZ#####ZHHHZ###ZAAAAAAAAZZZZAAZFFFFFFFFFFFFFFFFFFFFFZBBBBBBBBBBBBBBBBBBBBBBBBBBBBBBBBZ
################ZDDDDDDDDDDDDZ####ZGGGGGGGGGGGGZ###ZGGGZ############ZZZZCCCCCCCCCCCCCCCCCCCCCCCCCCCCZZZEEEEEEEEEEEEEEE####ZHHZZZZZZFFFFFFFFFFFFFFFFFFFFFFFFFFFFFFFFFFFFFZBBBBBBBBBBBBBBBBBBBBBBBBBBBBBBZ
################ZDDDDDDDDDDDDDDZZGGGZZZZZZZGGGGGGZGGGZ##########ZIIIIIIIIIZCCCCCCCCCCCCCCCCCCCCCCCCCZEEEEEEEEEEEEEEEEEZZZZHZFFFFFFFFFFFFFFFFFFFFFFFFFFFFFFFFFFFFFFFFFFFFFFZZBBBBBBBBBBBBBBBBBBBBBBBBBBBZ
###############ZDDDDDDDDDDDDDDDDDZJJJJJJJJJJJZGGGGZZZZZ#######ZIIIIIIIIIIIIIIZCCCCCCCCCCCCCCCCCCCCCCZEEEEEEEEEEEEEEEEEZHHHZFFFFFFFFFFFFFFFFFFFFFFFFFFFFFFFFFFFFFFFFFFFFFFFFFFFZBBBBBBBBBBBBBBBBBBBBBBBBZ
#############ZZDDDDDDDDDDDDDDDDDZJJJJJJJJJJJJJZZZIIIIIIIIZZZZIIIIIIIIIIIIIIIIZCCCCCCCCCCCCCCCCCCCCCZEEEEEEEEEEEEEEEEEEEZHHHZFFFFFFFFFFFFFFFFFFFFFFFFFFFFFFFFFFFFFFFFFFFFFFFFFFFFZBBBBBBBBBBBBBBBBBBBBBBZ
############ZKKZDDDDDDDDDDDDDDDDZJJJJJJJJJJJJJJZZIIIIIIIIIIIIIIIIIIIIIIIIIIIIZCCCCCCCZZZCCCCCCCCCZEEEEEEEEEEEEEEEEEEEEEEZHHZZZFFFZZZZZZZZFFFFFFFZZZZZZZZFFFFFFFFFFFFFFFFFFFFFFZBBBBBBBBBBBBBBBBBBBBBBBBZ
##########ZZKKKKKKZDDDDDDZZZZZZDZJJJJJJJJJJJJJJJJZZIIIIIIIIIIIIIIIIIIIIIIIIIIZCCCZZZLLLZZCCCCCZZEEEEEEEEEEEEEEEEEEEEEEEEEZHHHHZZHHHHHHHHHHZZZZZZHHHHHHHHHZZZZZZZZZFFFFFFFFFFFFZBBBBBBBBBBBBBZZZZ########
#########ZKKKKKKKKKKKZZZMMMMMMMZZZZZZJJJJJJJJJJJJJZIIIIIIIIIIIIIIIIIIIIIIIIIIZZZLLLLLLLLLZZZZEEEEEEEEEEEEEEEEEEEEEEEEEEEEZZHHHHHHHHHHHHHHHHHHHHHHHHHHHHHHHHHHHHHHHHZZZZZZZZZZZZZZBBBBBZZZZ##############
##########ZZKKKKKKKKKKKKKZZMMMMMMMMMMZZZJJJJJJJJJJJJZIIIIIIIIIIIIIIIIIIIIIZZLLLLLLLLLLLLLLLLZEEEEEEEEEEEEEEEEEEEEEEEEEEEZZHHHHHHHHHHHHHHHHHHHHHHHHHHHHHHHHHHHHHHHHHHHZZNNNNNNNNNNNZZZ###################
############ZKKKKKKKKKKKKKKKZZZMMMMMMMMMZZZZZZJJJJJZZIIIIIIIIIIIIIIIIIIIZLLLLLLLLLLLLLLLLLLLLZZZZZZZZEEEEEEZEEEEEEEEEEEEEEZHHHHHHHHHHHHHHHHHHHHHHHHHHHHHHHHHHHHHHHHHHHHHZNNNNNNNNNNNNZ##################
#############ZZZZKKKKKKKKKKKKKKZZZMMMMMMMMMMMMZZZZZZIIIIIIIIIIIIIIIIIIIZZLLLLLLLLLLLLLLLLLLLLLLLLLLLLZZZZZZLZEEEZZZZEEEEEEEZZHHHHHHHHHHHHHHHHHHHHHHHHHHHHHHHHHHHHHHHHHHHZZNNNNNNNNNNZ###################
################ZZKKKKKKKKKKKKKKKKKZMMMMMMMMMMMMMMZIIIIIIIIIIIIIIIIIIIZZLLLLLLLLLLLLLLLLLLLLLLLLLLLLLLLLLLLLLZZZHHHHHZZZZZZHHHHHHHHHHHHHHHHHHHHHHHHHHHHHHHHHHHHHHHHHHHHHZNNNNNNNNNNNNZ##################
###############ZZZZKKKKKKKKKKKKKKKKKZZZZZMMMMMMMMMZZIIIIIIIIIIIIIIIIIZLLLLLLLLLLLLLLLLLLLLLLLLLLLLLLLLLLLLLLLLLLZHHHHHHHHHHHHHHHHHHHHHHHHHHHHHHHHHHHHHHHHHHHHHHHHHHHHHHZNNNNNNNNNNNNZ###################
##################ZZKKKKKKKKKKKZZZOOOOOOOOZZMMMMMMMMZZIIIIIIIIIIIIIIIZLLLLLLLLLLLLLLLLLLLLLLLLLLLLLLLLLLLLLLLLLZZHHHHHHHHHHHHHHHHHHHHHHHHHHHHHHHHHHHHHHHHHHHHHHHHHZZZZNNNNNNNNNNNNZZ####################
#################ZZKKKKKKKKKKZZOOOOOOOOOOOOOZMMMMMZZPPZZIIIIIIIIIIIZLLLLLLLLLLLLLLLLLLLLLLLLLLLLLLLLLLLLLLLLLLLZHHHHHHHHHHHHHHHHHHHHHHHHHHHHHHHHHZZZZZZZZZZHHHHZQQZZNNNNNNNNNNNNNNNZZ###################
###############ZZKKKKKKKKKZZZZZOOOOOOOOOOOOOOZZZZPPPPPPPPZZIIZZZZZZLLLLLLLLLLLLLLLLLLLLLLLLLLLLLLLLLLLLLLLLLLLLLZHHHHHHHHHHHHHHHHHHHHHHZZZZZZZZZRRRRRRRRRRRZZZQQQQQQZNNNNNNNNNNNNNNNNZZ#################
##############ZZKKKKKKKKZ#ZSSSSSZZZOOOOOOOOOOZZPPPPPPPPPPPPZZPPPPPZLLLLLLLLLLLLLLLLLLLLLLLLLLLLLLLLLLLLLLLLLLLLLZHHHHHHHHHHHHHHHZZZZZZRRRRRRRRRRRRRRRRRRRRRRZQQQQQQZNNNNNNNNNNNNNNNNNNNZ################
################ZZZZZZZ#ZSSSSSSSSSSZZZZOOOOOOZPPPPPPPPPPPPPPPPPPZZZLLLLLLLLLLLLLLLLLLLLLLLLLLLLLLLLLLLLLLLLLLLZZZZZZZZZZZZZZZZZRRRRRRRRRRRRRRRRRRRRRRRRRRRRZQQQQQQQZNNNNNNNNNNNNNNNNNNNZZ###############
########################ZZSSSSSSSSSSSSSZZZZZZPPPPPPPPPPPPPPPPPZZTTTZZZLLLLLLLLLLLLLLLLLLLLLLLLLLLZZZZZZZZZZZZUUUUUUUUUUUZRRRRRRRRRRRRRRRRRRRRRRRRRRRRRRRZZQQQQQQQQQQZNNNNNZZZZZZZZZZNNZ#################
#############ZZZZZZZZ##ZSSSSSSSSSSSSSSSSSSSZPPPPPPPPPPPPPPPPZTTTTTTTTZZZZZZZZZLLLLLLZZZZZZZZZZZTTTTTTTZZUUUUUUUUUUUUUUUUUUZZZRRRRRRRRRRRRRRRRZZRRRRRZZZQQQQQQQQQQQQQQZZZZZVVVVVVVVVVZZZ#################
###########ZWWWWWWWWWZZZZZZSSSSSSSSSSSSSSSSSZPPPPPPPPPPPPPPPPZTTTTTTTTTTTTTTTTZZZZZZTTTTTTTTTTTTTTTTTTTTZUUUUUUUUUUZZZZUUUUUZZRRRRRRRRRRRRZZZZZZZZQQQQQQQQQQQQQQQQQQQZZVVVVVVVVVVVVVVVZ#################
##########ZWWWWWWWWWWWWWWWWZZZZZSSSSSSSSSSSSSZPPPPPPPPPPPPPPZZZTTTTTTTTTTTTTTTTTTTTTTTTTT#TTTTTTTTTTTTTTZZUUUUUZZZ######ZUUUUUUZRRRRRRRRZQQQQQQQQQQQQQQQQQQQQQQQQQQZVVVVVVVVVVVVVVVVVZ##################
###########ZZWWWWWWWWWWWWWWWZZXXZZZZZZZZZZZSSZPPPPPPPPPPZZZYYYYZZTTTTTTTTTTTTTTTTTTTTTTT#TTTTTTTTTTTTZZ##ZZZ###########ZZZZZZUUUZRRRRZZZQQQQQQQQQQQQQQQQQQQQQQQQQQQQZZVVVVVVVVVVVVVVVZ##################
#############ZZZWWWWWWWWWWWZXXXXXXXXXXXXXXXZZZZPPPPPPZZYYYYYYYYYZTTTTTTTTTTTTTTTTTTT###TTTTTTTTTTTZ###############ZZZ[[[[[[[[[[ZZZZZQQQQQQQQQQQQQQQQQQQQQQQQQQQQQQQQQQZZVVVVVVVVVVVVVVZZ################
################ZZZZZXXXXXXXXXXXXXXXXXXXXXXXXXXZYYYYYYYYYYYYYYYYZTTTZZZZZZZZZTTZ####ZTTTTZZZTTTZZ##################Z[[[[[[[[[[ZQQQQQQQQQQQQQQQQQQQQQQQQQQQQQQQQQQQQQQQQQZZVVVVVVVVVVVVVVZZ##############
#####################ZZZZZZZZXXXXXXXXXXXXXXXXXXXXZYYYYYYYYYYYYYZZZZ###Z\\\\\Z###Z\\\\\Z#####ZZZ#####################Z[[[[[[[[[[ZZZZZZZZQQQQQQQQQQQQQQQQQQQQQQQQQQQQQQQQQQZZVVVVVVVVVVVVVVVZZZ###########
##############################ZZZZZZZZZZXXXXXXXXXXZYYYYYYYYYZZZ#######Z\\\\Z##Z\\\\\\\Z##############################Z[[[[[[[[[[[[[[[ZQQQQQQQQQQQQQQQQQQQQQQQQQQQQQQQQQQQQQZVVVVVVVVVVVVVVVVVZZZZ#######
########################################ZZZZXXXXXXZYYZ#################ZZ\\Z#Z\\\\ZZZZ#################ZZZZZZ#######Z[[[[[[[[[[[[[[[ZQQQQQQQQQQQQQQQQQQQQQQQQQQQQQQQQQQQQQQQQZVVVVVVVVVVVVVVVVVVVZ######
############################################ZZZZZZZZZ###################Z\Z##Z\\\\\\\\ZZZ##############Z[[[[[[ZZZZZZ[[[[[[[[[[[[[[[[ZQQQQQQQQQQQQQQQQQQQQQQQQQQQQQQQQQQQQQQQQQZZVVVVVVVVVVVVVVVVVVZ#####
######################################################################Z\Z#Z\\\\\\\\\\\\\\ZZ#############Z[[[[[[[[[[[[[[[[[[[[[[[[[[[ZQQQQQQQQQQQQQQQQQQQQQQQQQQQQQQQQQQQQQQQZZVVVVVVVVVVVVVVVVVVVVZ#####
####################################################################Z\\\\\\\\\\\\\\\\\\\\Z###############ZZ[[[[[[[[[[[[[[[[[[[ZZZZZZZQQQQQQQQQQQQQQQQQQQQQQQQQQQQQQQQQQQQZZVVVVVVZ####ZZVVVVVVVZZZ######
###################################################################Z\ZZZ\\\\\\\\\\\\\\\\\\Z################ZZZZZZZZZZZZZZZZZZZ]]]]]]]ZZZQQQQQQQQQQQQQQQQQQQQQQQQQQQQQQQQZZVVVVVVZ#######ZZZZZZZ#########
###################################################################ZZ###ZZ\\\\\\\\\\\\\\\\Z#####################ZZ]]]]]]]]]]]]]]]]]]]]]]ZZZZZZZZZZZZZZZZZZQQQQQQQQQQQQZZZ#ZVVVVVVZZZZZZ#################
#####################################################################ZZZ##ZZZZZZZZZZZZZZ\\Z#######################ZZ]]]]]]]]]]]]]]]]]]]]]]]]]]]]]]Z########ZQQQQQQZZZZ#####ZZVVVVVVVVVVZZ###############
##################################################################ZZ\\\\Z###############ZZ#########################Z]]]]]]]]]]]]]]]]]]]]]]]]]]]ZZZ#######ZZZZZZZZZ###########ZVVVVVVVVZZ################
##################################################################Z\\\\\\Z####ZZZ###################################ZZZZZZZ]]]]]]]]]]]]]]]ZZZZZ#############################ZZZZZZZZZZ##################
###################################################################Z\\\\Z###Z\\\\Z#########################################ZZ]]]]]]]]]]]]]Z#############################################################
##################################################################Z\\\ZZ###Z\\\\\Z###########################################ZZ]]]]]]]]]]Z##############################################################
###################################################################ZZZ####Z\\\\\\\Z############################################ZZZZZZZZZZ###############################################################
#########################################################################Z\\\\\\Z#######################################################################################################################
##########################################################################ZZZZZZ########################################################################################################################
########################################################################################################################################################################################################
