###############################################################################################################################################################ZZZ######################################
##############################################################################################################################################################ZAAAZZ####################################
############################################################################################################################################################ZZAAAAAAZZZZZZZZ############################
#########################################################################################ZZZ###########################################################ZZZZZAAAAAAAAAAAAAAAAZZZZZZZZZZZZZZZZZZZZZZZ#####
#################ZZZZ#################################################################ZZZCCCZZ############################################ZZZ#######ZZZAAAAAAAAAAAAAAAAAAAZZBBBBBBBBBBBBBBBBBBBBBBBZZZZ#
###############ZZDDDDZZZZZZ########################################################ZZZCCCCCCCCZ##############ZZZZZ#####################ZZZAAAZZZZZZZAAAAAAAAAAAZZZZZZZZZZZBBBBBBBBBBBBBBBBBBBBBBBBBBBBBZ
###############ZZDDDDDDDDDZZ####################################################ZZZCCCCCCCCCCCCZZ##########ZZEEEEEZZ################ZZZAAAAAAAAAAAAAAAAAAAAAAAZFFFFZBBBBBBBBBBBBBBBBBBBBBBBBBBBBBBBBBBBZ
################ZDDDDDDDDDDDZ#######ZZZZZZZZZ##############################ZZZZZCCCCCCCCCCCCCCCCZ########ZZEEEEEEEEEZ###ZZZZZ#####ZZAAAAAAAAAAAAAAAAZZZZZZZZZZFFFFFFZBBBBBBBBBBBBBBBBBBBBBBBBBBBBBBBBBBZ
#################ZDDDDDDDDDDDZ#####ZGGGGGGGGGZZ#####ZZZ###################ZCCCCCCCCCCCCCCCCCCCCCCZZ#####ZEEEEEEEEEZZ#####ZHHHZ###ZAAAAAAAAZZZZZZZZZZFFFFFFFFFFFFFFFFFZZBBBBBBBBBBBBBBBBBBBBBBBBBBBBBBBBZ
################ZDDDDDDDDDDDDZ###ZZGGGGGGGGGGGGZZZZZGGGZ############ZZZZZZCCCCCCCCCCCCCCCCCCCCCCCCCZZZZZEEEEEEEEEEEEZZ####ZHHZZZZZZZZZZZZZFFFFFFFFFFFFFFFFFFFFFFFFFFFFFZZBBBBBBBBBBBBBBBBBBBBBBBBBBBBBBZ
################ZDDDDDDDDDDDDDZZZGGGZZZZZZZGGGGGGGGGGGZ#########ZZZZIIIIIIZZCCCCCCCCCCCCCCCCCCCCCCCCZEEEEEEEEEEEEEEEEEZZZZHHZFFFFFFFFFFFFFFFFFFFFFFFFFFFFFFFFFFFFFFFFFFFFZZZZBBBBBBBBBBBBBBBBBBBBBBBBBBZ
###############ZDDDDDDDDDDDDDDDDDZZZJJJJJJZZZZGGGGZZZZZ#######ZZIIIIIIIIIIIIZZCCCCCCCCCCCCCCCCCCCCCCZEEEEEEEEEEEEEEEEEZHHHHZFFFFFFFFFFFFFFFFFFFFFFFFFFFFFFFFFFFFFFFFFFFFFFFFFZZBBBBBBBBBBBBBBBBBBBBBBBBZ
#############ZZDDDDDDDDDDDDDDDDDZJJJJJJJJJJJJJZZZZIIIIIZZZZZZZIIIIIIIIIIIIIIIZCCCCCCCCCCCCCCCCCCCCZZEEEEEEEEEEEEEEEEEEEZHHHZFFFFFFFFFFFFFFFFFFFFFFFFFFFFFFFFFFFFFFFFFFFFFFFFFFFZBBBBBBBBBBBBBBBBBBBBBBBZ
############ZKKZDDDDDDDDDDDDDDDDZJJJJJJJJJJJJJJZZIIIIIIIIIIIIIIIIIIIIIIIIIIIIZCCCCCCZZZZCCCCCCCCZZEEEEEEEEEEEEEEEEEEEEEEZHHHZZZZZZZZZZZZZFFFFFFFZZZZZZZZFFFFFFFFFFFFFFFFFFFFFFZBBBBBBBBBBBBBBBBBZZZZZZZ#
##########ZZKKKKZZZDDDDDZZZZZZZDZJJJJJJJJJJJJJJJJZZIIIIIIIIIIIIIIIIIIIIIIIIIIZCCZZZZLLLZZCCCCZZZEEEEEEEEEEEEEEEEEEEEEEEEEZHHHHHHHHHHHHHHHZZZZZZZHHHHHHHHZZZZZZZZZZFFFFFFFFFFFFZBBBBBBBBBBBZZZZZZ########
#########ZKKKKKKKKKZZZZZMMMMMMMZZZZZZJJJJJJJJJJJJJZZIIIIIIIIIIIIIIIIIIIIIIIIZZZZLLLLLLLLLZZZZEEEEEEEEEEEEEEEEEEEEEEEEEEEEZZHHHHHHHHHHHHHHHHHHHHHHHHHHHHHHHHHHHHHHHZZZZZZZZZZZZZZZBBBBZZZZZ##############
##########ZZKKKKKKKKKKKKZZZMMMMMMMMMMZZZJJJJJJJJJJJJZIIIIIIIIIIIIIIIIIIIIZZZLLLLLLLLLLLLLLLLZEEEEEEEEEEEEEEEEEEEEEEEEEEEZZHHHHHHHHHHHHHHHHHHHHHHHHHHHHHHHHHHHHHHHHHHHZZNNNNNNNNNNZZZZ###################
############ZKKKKKKKKKKKKKKZZZZMMMMMMMMMZZZZZZJJJJJZZIIIIIIIIIIIIIIIIIIIZLLLLLLLLLLLLLLLLLLLLZZZZZZZZEEEEEEEEEEEEEEEEEEEEEZHHHHHHHHHHHHHHHHHHHHHHHHHHHHHHHHHHHHHHHHHHHHZZNNNNNNNNNNNNZ##################
#############ZZZZKKKKKKKKKKKKKKZZZMMMMMMMMMMMMZZZZZZIIIIIIIIIIIIIIIIIIIZLLLLLLLLLLLLLLLLLLLLLLLLLLLLLZZZZZZZZEEEZZZZEEEEEEEZZHHHHHHHHHHHHHHHHHHHHHHHHHHHHHHHHHHHHHHHHHHHZZNNNNNNNNNNZ###################
################ZZKKKKKKKKKKKKKKKKZZMMMMMMMMMMMMMMZIIIIIIIIIIIIIIIIIIIZLLLLLLLLLLLLLLLLLLLLLLLLLLLLLLLLLLLLLLZZZHHHHZZZZZZZHHHHHHHHHHHHHHHHHHHHHHHHHHHHHHHHHHHHHHHHHHHHHZNNNNNNNNNNNNZ##################
##################ZKKKKKKKKKKKKKKKKKZZZZZMMMMMMMMMZZIIIIIIIIIIIIIIIIIZLLLLLLLLLLLLLLLLLLLLLLLLLLLLLLLLLLLLLLLLLLZHHHHHHHHHHHHHHHHHHHHHHHHHHHHHHHHHHHHHHHHHHHHHHHHHHHHHZZNNNNNNNNNNNNZ###################
##################ZZKKKKKKKKKKKZZZZZOOOOOZZZMMMMMMMMZZIIIIIIIIIIIIIIZZLLLLLLLLLLLLLLLLLLLLLLLLLLLLLLLLLLLLLLLLLZZHHHHHHHHHHHHHHHHHHHHHHHHHHHHHHHHHHHHHHHHHHHHHHHZZZZZZNNNNNNNNNNNNZZ####################
#################ZZKKKKKKKKKKZZOOOOOOOOOOOOOZMMMMMZZPPZZIIIIIIIIIIIZZLLLLLLLLLLLLLLLLLLLLLLLLLLLLLLLLLLLLLLLLLLZHHHHHHHHHHHHHHHHHHHHHHHHHHHHHHHHZZZZZZZZZZZHHHZZQQZZNNNNNNNNNNNNNNNZZ###################
###############ZZKKKKKKKKZZZZZZOOOOOOOOOOOOOOZZZZZPPPPPPZZZIIZZZZZZLLLLLLLLLLLLLLLLLLLLLLLLLLLLLLLLLLLLLLLLLLLLLZHHHHHHHHHHHHHHHHHHHHHZZZZZZZZZZRRRRRRRRRRRZZZQQQQQQZNNNNNNNNNNNNNNNNZZ#################
##############ZZKKKKKKKZZSSSSSSZZZZOOOOOOOOOOZZPPPPPPPPPPPPZZPPPPPZLLLLLLLLLLLLLLLLLLLLLLLLLLLLLLLLLLLLLLLLLLLLLZHHHHHHHHHHHHHHZZZZZZZRRRRRRRRRRRRRRRRRRRRRRZQQQQQQZNNNNNNNNNNNNNNNNNNNZ################
################ZZZZZZZ#ZSSSSSSSSSSZZZZOOOOOOZPPPPPPPPPPPPPPPPPPZZZLLLLLLLLLLLLLLLLLLLLLLLLLLLLLLLLLLLLLLLLLLZZZZZZZZZZZZZZZZZZRRRRRRRRRRRRRRRRRRRRRRRRRRRRZQQQQQQQZNNNNNNNNNNNNNNNNNNNZZ###############
########################ZZSSSSSSSSSSSSSZZZZZZPPPPPPPPPPPPPPPPZZZTTTZZZLLLLLLLLLLLLLLLLLLLLLLLLLZZZZZZZZZZZZZZUUUUUUUUUUUZRRRRRRRRRRRRRRRRRRRRRRRRRRRRRRRZZQQQQQQQQQQZNNNNNZZZZZZZZZZNNZ#################
############ZZZZZZZZZ##ZSSSSSSSSSSSSSSSSSSSZPPPPPPPPPPPPPPPPZTTTTTTTTZZZZZZZZZLLLLLLZZZZZZZZZZZTTTTTTTZZUUUUUUUUUUUUUUUUUZZZZRRRRRRRRRRRRRRRRRRRRRRRZZZZQQQQQQQQQQQQQZZZZZVVVVVVVVVVZZZ#################
###########ZWWWWWWWWWZZZZZZSSSSSSSSSSSSSSSSSZPPPPPPPPPPPPPPPPZTTTTTTTTTTTTTTTTZZZZZZTTTTTTTTTTTTTTTTTTTTZUUUUUUUUUUZZZZUUUUUZZRRRRRRRRRRRZZZZZZZZZZZQQQQQQQQQQQQQQQQZVVVVVVVVVVVVVVVVVZ#################
##########ZWWWWWWWWWWWWWWWWZZZZZSSSSSSSSSSSSSZPPPPPPPPPPPPPZZZZTTTTTTTTTTTTTTTTTTTTTTTTTZZTTTTTTTTTTTTTTZZUUUUUZZZZ####ZUUUUUUUZRRRRRRRRZQQQQQQQQQQQQQQQQQQQQQQQQQQZVVVVVVVVVVVVVVVVVZ##################
###########ZZWWWWWWWWWWWWWWWZZXXZZZZZZZZZZZSSZPPPPPPPPPPZZZYYYYZZTTTTTTTTTTTTTTTTTTTZZZZ#ZTTTTTTTTTTZZZZ#ZZZZZZ########ZZZZZZUUUZRRRZZZZQQQQQQQQQQQQQQQQQQQQQQQQQQQQZZVVVVVVVVVVVVVVVZ##################
#############ZZZWWWWWWWWWWWZXXXXXXXXXXXXXXXZZZZPZZZZZZZZYYYYYYYYZTTTTTTTTTTTTTTTZZZZ###ZZTTTTTTTTTZZ##############ZZZZZ[[[[[[ZZZZZZZQQQQQQQQQQQQQQQQQQQQQQQQQQQQQQQQQQZZVVVVVVVVVVVVVVZZ################
################ZZZZZZZZZZZXXXXXXXXXXXXXXXXXXXXZYYYYYYYYYYYYYYYYZTTTZZZZZZZZZZZZ####ZZZZZZZZTTTZZZ#################Z[[[[[[[[[[ZQQQQQQQQQQQQQQQQQQQQQQQQQQQQQQQQQQQQQQQQQZZVVVVVVVVVVVVVVZZ##############
###########################ZZXXXXXXXXXXXXXXXXXXXZZYYYYYYYYYYYYYZZZZZ##Z\\\\\Z###ZZZZ\\Z#####ZZZ#####################Z[[[[[[[[[[ZZZZZZQQQQQQQQQQQQQQQQQQQQQQQQQQQQQQQQQQQQZZVVVVVVVVVVVVVVVZZZ###########
#############################ZZZZZZZZZZZXXXXXXXXXXZYYYYYYYYYZZZ#######Z\\\\Z##ZZ\\\\\\Z##############################Z[[[[[[[[[[[[[[[ZQQQQQQQQQQQQQQQQQQQQQQQQQQQQQQQQQQQQQZVVVVVVVVVVVVVVVVVZZZZ#######
########################################ZZZZXXXXXXZYYZZZZZZZ###########ZZ\\Z#Z\\\\ZZZZ#################ZZZZZZZ######Z[[[[[[[[[[[[[[[ZQQQQQQQQQQQQQQQQQQQQQQQQQQQQQQQQQQQQQQQZZVVVVVVVVVVVVVVVVVVVZ######
############################################ZZZZZZZZZ###################Z\Z##Z\\\\\\\\ZZZ##############Z[[[[[[ZZZZZZ[[[[[[[[[[[[[[[[ZQQQQQQQQQQQQQQQQQQQQQQQQQQQQQQQQQQQQQQQQQZZVVVVVVVVVVVVVVVVVVZ#####
#####################################################################ZZZ\\\ZZ\\\\\\\\\\\\Z##############Z[[[[[[[[[[[[[[[[[[[[[[[[[[[ZQQQQQQQQQQQQQQQQQQQQQQQQQQQQQQQQQQQQQQZZZVVVVVVVVVVVVVVVVVVVVZ#####
####################################################################Z\\\\\\\\\\\\\\\\\\\\Z###############ZZ[[[[[[[[[[[[[[[[[[[ZZZZZZZQQQQQQQQQQQQQQQQQQQQQQQQQQQQQQQQQQQQZZVVVVVVZZZZZZZVVVVVVVZZZ######
###################################################################Z\ZZZ\\\\\\\\\\\\\\\\\\Z################ZZZZZZZZZZZZZZZZZZZ]]]]]]]ZZZQQQQQQQQQQQQQQQQQQQQQQQQQQQQQQQQZZVVVVVVZ#######ZZZZZZZ#########
###################################################################ZZ###ZZ\\\\\\\\\\\\\\\\Z#####################ZZ]]]]]]]]]]]]]]]]]]]]]]ZZZZZZZZZZZZZZZZZZZQQQQQQQQQQQZZZ#ZVVVVVVZZZZZZ#################
#####################################################################ZZZ##ZZZZZZZZZZZZZZ\\Z#######################ZZ]]]]]]]]]]]]]]]]]]]]]]]]]]]]]]Z########ZQQQQQQZZZZ#####ZZVVVVVVVVVVZZ###############
###################################################################ZZ\\\Z###############ZZ#########################Z]]]]]]]]]]]]]]]]]]]]]]]]]]]ZZZ##########ZZZZZZ###########ZVVVVVVVVZZ################
##################################################################Z\\\\\\Z###ZZZZ###################################ZZZZZZZ]]]]]]]]]]]]]]]ZZZZZ##############################ZZZZZZZZZ##################
###################################################################Z\\\\Z###Z\\\\Z#########################################ZZ]]]]]]]]]]]]]Z#############################################################
##################################################################Z\\\ZZ###Z\\\\\Z###########################################ZZ]]]]]]]]]]Z##############################################################
###################################################################ZZZ####Z\\\\\\\Z############################################ZZZZZZZZZZ###############################################################
#########################################################################Z\\\\\\ZZ######################################################################################################################
##########################################################################ZZZZZZ########################################################################################################################
########################################################################################################################################################################################################
